,pcode,month_id,count,filled,unfilled,filled_pct,pl_pct
0,3BPD,2018_11,254,203,51,79.9,0.153
1,3BPD,2018_12,640,558,82,87.2,-0.005
2,3BPD,2019_01,250,203,47,81.2,-0.005
3,3BPD,2019_02,87,77,10,88.5,0.045
4,3BPD,2019_03,102,86,16,84.3,-0.045
5,3BPD,2019_04,104,81,23,77.9,-0.016
6,3BPD,2019_05,341,304,37,89.1,0.034
7,3BPD,2019_06,106,88,18,83.0,0.005
8,3BPD,2019_07,139,114,25,82.0,0.055
9,3BPD,2019_08,372,328,44,88.2,0.037
10,3BPD,2019_09,174,141,33,81.0,0.09
11,3BPD,2019_10,153,128,25,83.7,0.033
12,3BPD,2019_11,110,87,23,79.1,-0.507
13,3BPD,2019_12,95,77,18,81.1,-0.062
14,3BPD,2020_01,239,198,41,82.8,0.068
15,3BPD,2020_02,412,366,46,88.8,0.095
16,3BPD,2020_03,868,699,169,80.5,0.234
17,3BPD,2020_04,897,676,221,75.4,0.126
18,3BPD,2020_05,484,395,89,81.6,0.034
19,3BPD,2020_06,826,729,97,88.3,0.135
20,3BPD,2020_07,593,499,94,84.1,0.02
21,3BPD,2020_08,287,239,48,83.3,-0.02
22,3BPD,2020_09,623,481,142,77.2,-0.103
23,3BPD,2020_10,412,351,61,85.2,0.031
24,3BPD,2020_11,430,350,80,81.4,0.048
25,3BPD,2020_12,474,407,67,85.9,0.055
26,3BPD,2021_01,606,521,85,86.0,0.111
27,3BPD,2021_02,476,392,84,82.4,0.041
28,3BPD,2021_03,631,520,111,82.4,0.125
29,3BPD,2021_04,272,236,36,86.8,0.039
30,3BPD,2021_05,389,329,60,84.6,0.06
31,3BPD,2021_06,260,210,50,80.8,0.104
32,3BPD,2021_07,283,232,51,82.0,0.026
33,3BPD,2021_08,221,184,37,83.3,0.036
34,3BPD,2021_09,294,251,43,85.4,0.023
35,3BPD,2021_10,255,218,37,85.5,0.142
36,3BPD,2021_11,462,382,80,82.7,0.127
37,3BPD,2021_12,410,353,57,86.1,0.071
38,3BPD,2022_01,625,544,81,87.0,0.006
39,3BPD,2022_02,573,499,74,87.1,0.136
40,3BPD,2022_03,602,503,99,83.6,0.142
41,3BPD,2022_04,417,358,59,85.9,0.12
42,3BPD,2022_05,877,740,137,84.4,0.085
43,3BPD,2022_06,920,807,113,87.7,0.073
44,3BPD,2022_07,682,501,181,73.5,0.068
45,3BPD,2022_08,556,467,89,84.0,-0.014
46,3BPD,2022_09,438,357,81,81.5,0.071
47,3BPD,2022_10,674,566,108,84.0,0.011
48,3BPD,2022_11,840,681,159,81.1,0.094
49,3BPD,2022_12,70,61,9,87.1,0.12
50,3BPU,2018_11,305,264,41,86.6,0.072
51,3BPU,2018_12,734,652,82,88.8,0.126
52,3BPU,2019_01,362,315,47,87.0,0.031
53,3BPU,2019_02,93,75,18,80.6,-0.059
54,3BPU,2019_03,125,99,26,79.2,0.051
55,3BPU,2019_04,124,106,18,85.5,-0.021
56,3BPU,2019_05,324,269,55,83.0,-0.0
57,3BPU,2019_06,122,99,23,81.1,0.044
58,3BPU,2019_07,108,83,25,76.9,-0.051
59,3BPU,2019_08,333,255,78,76.6,-0.077
60,3BPU,2019_09,185,155,30,83.8,0.066
61,3BPU,2019_10,202,177,25,87.6,0.041
62,3BPU,2019_11,113,95,18,84.1,0.056
63,3BPU,2019_12,149,128,21,85.9,0.027
64,3BPU,2020_01,238,197,41,82.8,0.035
65,3BPU,2020_02,414,368,46,88.9,0.261
66,3BPU,2020_03,967,728,239,75.3,0.268
67,3BPU,2020_04,892,700,192,78.5,0.295
68,3BPU,2020_05,423,369,54,87.2,0.196
69,3BPU,2020_06,679,557,122,82.0,0.226
70,3BPU,2020_07,574,503,71,87.6,0.017
71,3BPU,2020_08,307,266,41,86.6,0.072
72,3BPU,2020_09,471,393,78,83.4,0.348
73,3BPU,2020_10,591,502,89,84.9,0.062
74,3BPU,2020_11,483,417,66,86.3,0.061
75,3BPU,2020_12,528,446,82,84.5,0.074
76,3BPU,2021_01,615,530,85,86.2,0.056
77,3BPU,2021_02,525,440,85,83.8,0.091
78,3BPU,2021_03,734,632,102,86.1,0.131
79,3BPU,2021_04,336,278,58,82.7,0.083
80,3BPU,2021_05,417,361,56,86.6,0.026
81,3BPU,2021_06,235,195,40,83.0,0.037
82,3BPU,2021_07,357,311,46,87.1,0.067
83,3BPU,2021_08,265,214,51,80.8,0.033
84,3BPU,2021_09,258,225,33,87.2,-0.027
85,3BPU,2021_10,268,238,30,88.8,0.039
86,3BPU,2021_11,404,338,66,83.7,0.104
87,3BPU,2021_12,433,371,62,85.7,0.016
88,3BPU,2022_01,471,364,107,77.3,-0.08
89,3BPU,2022_02,620,534,86,86.1,0.046
90,3BPU,2022_03,771,612,159,79.4,0.061
91,3BPU,2022_04,388,304,84,78.4,0.003
92,3BPU,2022_05,753,600,153,79.7,-0.047
93,3BPU,2022_06,894,755,139,84.5,0.047
94,3BPU,2022_07,740,600,140,81.1,0.037
95,3BPU,2022_08,420,353,67,84.0,0.011
96,3BPU,2022_09,524,464,60,88.5,0.022
97,3BPU,2022_10,884,779,105,88.1,0.062
98,3BPU,2022_11,787,665,122,84.5,0.099
99,3BPU,2022_12,57,48,9,84.2,0.03
100,BFLD,2018_11,232,199,33,85.8,0.053
101,BFLD,2018_12,290,258,32,89.0,0.111
102,BFLD,2019_01,133,111,22,83.5,-0.035
103,BFLD,2019_02,69,56,13,81.2,-0.135
104,BFLD,2019_03,86,73,13,84.9,0.033
105,BFLD,2019_04,67,53,14,79.1,0.096
106,BFLD,2019_05,371,324,47,87.3,0.103
107,BFLD,2019_06,57,47,10,82.5,0.139
108,BFLD,2019_07,96,87,9,90.6,0.028
109,BFLD,2019_08,262,248,14,94.7,0.057
110,BFLD,2019_09,140,122,18,87.1,0.03
111,BFLD,2019_10,119,103,16,86.6,0.057
112,BFLD,2019_11,76,66,10,86.8,0.026
113,BFLD,2019_12,117,102,15,87.2,0.076
114,BFLD,2020_01,235,208,27,88.5,0.083
115,BFLD,2020_02,400,362,38,90.5,0.072
116,BFLD,2020_03,1025,890,135,86.8,0.164
117,BFLD,2020_04,706,648,58,91.8,0.062
118,BFLD,2020_05,303,274,29,90.4,0.075
119,BFLD,2020_06,541,463,78,85.6,0.058
120,BFLD,2020_07,341,288,53,84.5,-0.052
121,BFLD,2020_08,220,189,31,85.9,0.097
122,BFLD,2020_09,350,311,39,88.9,0.069
123,BFLD,2020_10,460,402,58,87.4,0.044
124,BFLD,2020_11,228,191,37,83.8,0.081
125,BFLD,2020_12,332,284,48,85.5,0.007
126,BFLD,2021_01,488,419,69,85.9,-0.07
127,BFLD,2021_02,458,384,74,83.8,0.062
128,BFLD,2021_03,476,414,62,87.0,0.11
129,BFLD,2021_04,216,193,23,89.4,-0.007
130,BFLD,2021_05,354,316,38,89.3,0.069
131,BFLD,2021_06,174,158,16,90.8,0.076
132,BFLD,2021_07,331,280,51,84.6,0.013
133,BFLD,2021_08,209,177,32,84.7,0.069
134,BFLD,2021_09,264,242,22,91.7,0.118
135,BFLD,2021_10,161,144,17,89.4,0.042
136,BFLD,2021_11,470,366,104,77.9,-0.113
137,BFLD,2021_12,296,274,22,92.6,-0.005
138,BFLD,2022_01,360,324,36,90.0,0.161
139,BFLD,2022_02,428,372,56,86.9,0.028
140,BFLD,2022_03,452,401,51,88.7,0.075
141,BFLD,2022_04,317,286,31,90.2,0.093
142,BFLD,2022_05,406,366,40,90.1,0.125
143,BFLD,2022_06,642,583,59,90.8,0.047
144,BFLD,2022_07,441,381,60,86.4,-0.009
145,BFLD,2022_08,372,336,36,90.3,0.072
146,BFLD,2022_09,422,375,47,88.9,0.046
147,BFLD,2022_10,399,329,70,82.5,0.117
148,BFLD,2022_11,487,407,80,83.6,0.015
149,BFLD,2022_12,72,67,5,93.1,0.081
150,BFLU,2018_11,197,174,23,88.3,0.047
151,BFLU,2018_12,267,219,48,82.0,-0.009
152,BFLU,2019_01,278,242,36,87.1,0.055
153,BFLU,2019_02,119,106,13,89.1,0.02
154,BFLU,2019_03,118,98,20,83.1,-0.03
155,BFLU,2019_04,119,95,24,79.8,0.101
156,BFLU,2019_05,121,106,15,87.6,-0.045
157,BFLU,2019_06,140,126,14,90.0,-0.022
158,BFLU,2019_07,151,128,23,84.8,-0.017
159,BFLU,2019_08,243,224,19,92.2,0.01
160,BFLU,2019_09,153,135,18,88.2,0.05
161,BFLU,2019_10,210,201,9,95.7,0.028
162,BFLU,2019_11,137,126,11,92.0,-0.02
163,BFLU,2019_12,122,103,19,84.4,0.027
164,BFLU,2020_01,166,151,15,91.0,0.09
165,BFLU,2020_02,257,231,26,89.9,0.015
166,BFLU,2020_03,583,504,79,86.4,0.194
167,BFLU,2020_04,958,853,105,89.0,0.09
168,BFLU,2020_05,440,383,57,87.0,0.066
169,BFLU,2020_06,615,504,111,82.0,0.009
170,BFLU,2020_07,488,427,61,87.5,0.126
171,BFLU,2020_08,323,292,31,90.4,0.033
172,BFLU,2020_09,340,300,40,88.2,0.073
173,BFLU,2020_10,371,329,42,88.7,0.125
174,BFLU,2020_11,570,496,74,87.0,0.12
175,BFLU,2020_12,530,467,63,88.1,-0.016
176,BFLU,2021_01,580,514,66,88.6,0.081
177,BFLU,2021_02,643,571,72,88.8,0.147
178,BFLU,2021_03,531,484,47,91.1,0.055
179,BFLU,2021_04,316,278,38,88.0,-0.045
180,BFLU,2021_05,308,266,42,86.4,0.037
181,BFLU,2021_06,212,178,34,84.0,11.165
182,BFLU,2021_07,199,181,18,91.0,0.068
183,BFLU,2021_08,211,188,23,89.1,0.064
184,BFLU,2021_09,165,147,18,89.1,0.011
185,BFLU,2021_10,301,262,39,87.0,0.09
186,BFLU,2021_11,328,282,46,86.0,0.04
187,BFLU,2021_12,362,327,35,90.3,0.067
188,BFLU,2022_01,275,247,28,89.8,0.088
189,BFLU,2022_02,373,337,36,90.3,0.09
190,BFLU,2022_03,608,537,71,88.3,0.03
191,BFLU,2022_04,259,223,36,86.1,0.03
192,BFLU,2022_05,376,325,51,86.4,0.039
193,BFLU,2022_06,386,341,45,88.3,0.054
194,BFLU,2022_07,529,467,62,88.3,0.089
195,BFLU,2022_08,336,296,40,88.1,-0.04
196,BFLU,2022_09,248,215,33,86.7,-0.036
197,BFLU,2022_10,577,509,68,88.2,0.058
198,BFLU,2022_11,588,509,79,86.6,0.034
199,BFLU,2022_12,34,30,4,88.2,-0.082
200,BOD,2018_11,702,608,94,86.6,-0.053
201,BOD,2018_12,456,357,99,78.3,0.044
202,BOD,2019_01,527,420,107,79.7,-0.292
203,BOD,2019_02,496,386,110,77.8,0.07
204,BOD,2019_03,464,373,91,80.4,-0.175
205,BOD,2019_04,492,394,98,80.1,0.112
206,BOD,2019_05,1342,1002,340,74.7,-0.01
207,BOD,2019_06,371,302,69,81.4,0.14
208,BOD,2019_07,501,392,109,78.2,0.054
209,BOD,2019_08,1049,837,212,79.8,-0.031
210,BOD,2019_09,731,573,158,78.4,-0.042
211,BOD,2019_10,603,460,143,76.3,0.033
212,BOD,2019_11,526,439,87,83.5,0.208
213,BOD,2019_12,565,408,157,72.2,-0.086
214,BOD,2020_01,1330,1068,262,80.3,0.103
215,BOD,2020_02,1186,990,196,83.5,0.298
216,BOD,2020_03,3549,2981,568,84.0,0.746
217,BOD,2020_04,1832,1406,426,76.7,-0.196
218,BOD,2020_05,1001,791,210,79.0,0.051
219,BOD,2020_06,1524,1234,290,81.0,0.115
220,BOD,2020_07,1327,1035,292,78.0,-0.154
221,BOD,2020_08,887,678,209,76.4,0.154
222,BOD,2020_09,1257,1024,233,81.5,0.087
223,BOD,2020_10,911,724,187,79.5,-0.037
224,BOD,2020_11,868,687,181,79.1,-0.112
225,BOD,2020_12,1119,820,299,73.3,-0.034
226,BOD,2021_01,1687,1300,387,77.1,-0.004
227,BOD,2021_02,1868,1399,469,74.9,0.043
228,BOD,2021_03,1069,859,210,80.4,-0.178
229,BOD,2021_04,780,600,180,76.9,-0.083
230,BOD,2021_05,1048,828,220,79.0,0.047
231,BOD,2021_06,784,653,131,83.3,0.252
232,BOD,2021_07,918,747,171,81.4,0.257
233,BOD,2021_08,1203,966,237,80.3,0.16
234,BOD,2021_09,987,822,165,83.3,-0.045
235,BOD,2021_10,755,619,136,82.0,0.072
236,BOD,2021_11,1063,822,241,77.3,0.206
237,BOD,2021_12,1082,859,223,79.4,-0.177
238,BOD,2022_01,753,624,129,82.9,0.52
239,BOD,2022_02,1078,819,259,76.0,0.185
240,BOD,2022_03,1355,1079,276,79.6,0.205
241,BOD,2022_04,953,731,222,76.7,0.039
242,BOD,2022_05,921,754,167,81.9,0.393
243,BOD,2022_06,2302,1765,537,76.7,0.082
244,BOD,2022_07,1517,1181,336,77.9,-0.139
245,BOD,2022_08,1601,1287,314,80.4,0.03
246,BOD,2022_09,1197,1006,191,84.0,0.238
247,BOD,2022_10,1164,918,246,78.9,-0.044
248,BOD,2022_11,1638,1273,365,77.7,-0.122
249,BOD,2022_12,228,191,37,83.8,0.111
250,BOU,2018_11,933,756,177,81.0,0.047
251,BOU,2018_12,975,717,258,73.5,-0.081
252,BOU,2019_01,1271,1096,175,86.2,0.173
253,BOU,2019_02,889,731,158,82.2,0.088
254,BOU,2019_03,762,631,131,82.8,0.283
255,BOU,2019_04,972,818,154,84.2,0.159
256,BOU,2019_05,941,787,154,83.6,-0.259
257,BOU,2019_06,1114,955,159,85.7,0.188
258,BOU,2019_07,1270,987,283,77.7,0.057
259,BOU,2019_08,1832,1565,267,85.4,0.023
260,BOU,2019_09,1448,1235,213,85.3,0.23
261,BOU,2019_10,1061,913,148,86.1,0.302
262,BOU,2019_11,1007,861,146,85.5,0.192
263,BOU,2019_12,1131,864,267,76.4,0.123
264,BOU,2020_01,1130,933,197,82.6,-0.036
265,BOU,2020_02,1733,1416,317,81.7,0.191
266,BOU,2020_03,2045,1632,413,79.8,0.369
267,BOU,2020_04,4347,3342,1005,76.9,0.183
268,BOU,2020_05,2695,2198,497,81.6,0.147
269,BOU,2020_06,2652,2086,566,78.7,-0.112
270,BOU,2020_07,2996,2550,446,85.1,0.226
271,BOU,2020_08,1752,1438,314,82.1,0.129
272,BOU,2020_09,1740,1444,296,83.0,0.1
273,BOU,2020_10,1630,1394,236,85.5,0.202
274,BOU,2020_11,3742,2942,800,78.6,0.19
275,BOU,2020_12,2459,2084,375,84.7,0.039
276,BOU,2021_01,2501,2023,478,80.9,0.092
277,BOU,2021_02,2783,2271,512,81.6,1.261
278,BOU,2021_03,2252,1785,467,79.3,0.076
279,BOU,2021_04,1203,973,230,80.9,0.034
280,BOU,2021_05,1706,1424,282,83.5,0.067
281,BOU,2021_06,1235,1005,230,81.4,0.173
282,BOU,2021_07,1328,1074,254,80.9,-0.097
283,BOU,2021_08,1559,1296,263,83.1,0.033
284,BOU,2021_09,1150,897,253,78.0,-0.148
285,BOU,2021_10,1637,1321,316,80.7,0.143
286,BOU,2021_11,1907,1507,400,79.0,-0.207
287,BOU,2021_12,1873,1529,344,81.6,-0.054
288,BOU,2022_01,1229,992,237,80.7,0.119
289,BOU,2022_02,1743,1426,317,81.8,0.023
290,BOU,2022_03,2584,2083,501,80.6,0.124
291,BOU,2022_04,1118,894,224,80.0,-0.18
292,BOU,2022_05,1788,1460,328,81.7,-0.098
293,BOU,2022_06,2251,1810,441,80.4,-0.17
294,BOU,2022_07,3548,3003,545,84.6,0.175
295,BOU,2022_08,2252,1798,454,79.8,0.051
296,BOU,2022_09,940,770,170,81.9,0.05
297,BOU,2022_10,2770,2287,483,82.6,0.233
298,BOU,2022_11,3684,3019,665,81.9,0.556
299,BOU,2022_12,275,218,57,79.3,0.026
300,BTRD,2018_11,51,47,4,92.2,0.116
301,BTRD,2018_12,44,42,2,95.5,0.212
302,BTRD,2019_01,29,23,6,79.3,0.253
303,BTRD,2019_02,18,16,2,88.9,0.011
304,BTRD,2019_03,19,17,2,89.5,0.056
305,BTRD,2019_04,31,26,5,83.9,0.122
306,BTRD,2019_05,74,65,9,87.8,-0.071
307,BTRD,2019_06,10,10,0,100.0,-0.11
308,BTRD,2019_07,29,24,5,82.8,0.001
309,BTRD,2019_08,61,56,5,91.8,0.024
310,BTRD,2019_09,25,19,6,76.0,0.054
311,BTRD,2019_10,23,19,4,82.6,0.627
312,BTRD,2019_11,29,27,2,93.1,-0.109
313,BTRD,2019_12,15,12,3,80.0,0.064
314,BTRD,2020_01,66,61,5,92.4,0.08
315,BTRD,2020_02,81,71,10,87.7,0.21
316,BTRD,2020_03,345,315,30,91.3,0.261
317,BTRD,2020_04,164,145,19,88.4,-0.05
318,BTRD,2020_05,56,49,7,87.5,0.073
319,BTRD,2020_06,95,88,7,92.6,0.126
320,BTRD,2020_07,79,67,12,84.8,-0.107
321,BTRD,2020_08,43,34,9,79.1,0.061
322,BTRD,2020_09,62,51,11,82.3,0.022
323,BTRD,2020_10,68,56,12,82.4,0.073
324,BTRD,2020_11,49,41,8,83.7,0.07
325,BTRD,2020_12,67,64,3,95.5,0.039
326,BTRD,2021_01,97,89,8,91.8,-0.117
327,BTRD,2021_02,93,72,21,77.4,0.109
328,BTRD,2021_03,56,52,4,92.9,0.221
329,BTRD,2021_04,61,52,9,85.2,0.155
330,BTRD,2021_05,59,56,3,94.9,0.019
331,BTRD,2021_06,41,39,2,95.1,0.048
332,BTRD,2021_07,50,43,7,86.0,0.362
333,BTRD,2021_08,51,43,8,84.3,0.142
334,BTRD,2021_09,73,68,5,93.2,-0.03
335,BTRD,2021_10,34,34,0,100.0,0.218
336,BTRD,2021_11,58,48,10,82.8,0.049
337,BTRD,2021_12,39,37,2,94.9,0.089
338,BTRD,2022_01,83,72,11,86.7,0.129
339,BTRD,2022_02,68,63,5,92.6,0.085
340,BTRD,2022_03,98,80,18,81.6,0.03
341,BTRD,2022_04,90,82,8,91.1,0.082
342,BTRD,2022_05,113,111,2,98.2,0.115
343,BTRD,2022_06,120,108,12,90.0,-0.046
344,BTRD,2022_07,71,60,11,84.5,-0.068
345,BTRD,2022_08,86,77,9,89.5,0.172
346,BTRD,2022_09,83,74,9,89.2,-0.044
347,BTRD,2022_10,80,65,15,81.2,-0.009
348,BTRD,2022_11,96,84,12,87.5,0.096
349,BTRD,2022_12,11,11,0,100.0,-0.209
350,BTRU,2018_11,39,35,4,89.7,0.064
351,BTRU,2018_12,37,30,7,81.1,0.07
352,BTRU,2019_01,45,43,2,95.6,0.188
353,BTRU,2019_02,25,23,2,92.0,0.004
354,BTRU,2019_03,23,19,4,82.6,0.085
355,BTRU,2019_04,22,19,3,86.4,0.083
356,BTRU,2019_05,32,29,3,90.6,-0.026
357,BTRU,2019_06,34,27,7,79.4,0.042
358,BTRU,2019_07,42,36,6,85.7,-0.103
359,BTRU,2019_08,56,50,6,89.3,0.026
360,BTRU,2019_09,42,36,6,85.7,0.122
361,BTRU,2019_10,38,30,8,78.9,0.111
362,BTRU,2019_11,23,23,0,100.0,0.084
363,BTRU,2019_12,27,24,3,88.9,0.165
364,BTRU,2020_01,24,19,5,79.2,0.079
365,BTRU,2020_02,63,60,3,95.2,0.124
366,BTRU,2020_03,125,111,14,88.8,0.089
367,BTRU,2020_04,165,142,23,86.1,0.03
368,BTRU,2020_05,100,88,12,88.0,0.062
369,BTRU,2020_06,99,86,13,86.9,0.151
370,BTRU,2020_07,89,77,12,86.5,0.009
371,BTRU,2020_08,49,40,9,81.6,0.089
372,BTRU,2020_09,71,64,7,90.1,0.033
373,BTRU,2020_10,84,80,4,95.2,0.132
374,BTRU,2020_11,138,119,19,86.2,0.323
375,BTRU,2020_12,91,74,17,81.3,0.031
376,BTRU,2021_01,122,115,7,94.3,0.133
377,BTRU,2021_02,147,120,27,81.6,0.191
378,BTRU,2021_03,118,103,15,87.3,-0.01
379,BTRU,2021_04,58,51,7,87.9,-0.02
380,BTRU,2021_05,65,60,5,92.3,-0.027
381,BTRU,2021_06,52,45,7,86.5,-0.065
382,BTRU,2021_07,48,38,10,79.2,0.021
383,BTRU,2021_08,46,40,6,87.0,0.104
384,BTRU,2021_09,37,30,7,81.1,-0.075
385,BTRU,2021_10,54,51,3,94.4,0.088
386,BTRU,2021_11,81,68,13,84.0,-0.027
387,BTRU,2021_12,84,75,9,89.3,0.029
388,BTRU,2022_01,60,55,5,91.7,-0.011
389,BTRU,2022_02,78,66,12,84.6,0.132
390,BTRU,2022_03,113,94,19,83.2,-0.044
391,BTRU,2022_04,47,43,4,91.5,0.038
392,BTRU,2022_05,59,49,10,83.1,0.001
393,BTRU,2022_06,75,64,11,85.3,0.057
394,BTRU,2022_07,140,120,20,85.7,-0.017
395,BTRU,2022_08,79,69,10,87.3,0.004
396,BTRU,2022_09,44,39,5,88.6,-0.151
397,BTRU,2022_10,118,108,10,91.5,-0.066
398,BTRU,2022_11,113,96,17,85.0,-0.016
399,BTRU,2022_12,7,7,0,100.0,-0.154
400,CCB,2018_11,384,336,48,87.5,-0.007
401,CCB,2018_12,740,618,122,83.5,-0.067
402,CCB,2019_01,509,452,57,88.8,0.284
403,CCB,2019_02,156,130,26,83.3,0.085
404,CCB,2019_03,219,187,32,85.4,0.026
405,CCB,2019_04,180,152,28,84.4,0.036
406,CCB,2019_05,233,202,31,86.7,0.092
407,CCB,2019_06,362,311,51,85.9,-0.033
408,CCB,2019_07,338,276,62,81.7,-0.048
409,CCB,2019_08,319,275,44,86.2,0.013
410,CCB,2019_09,300,237,63,79.0,0.024
411,CCB,2019_10,287,254,33,88.5,-0.035
412,CCB,2019_11,179,153,26,85.5,0.048
413,CCB,2019_12,152,119,33,78.3,0.081
414,CCB,2020_01,282,239,43,84.8,0.002
415,CCB,2020_02,411,350,61,85.2,0.081
416,CCB,2020_03,1238,1050,188,84.8,-0.039
417,CCB,2020_04,1361,1121,240,82.4,0.066
418,CCB,2020_05,907,774,133,85.3,0.089
419,CCB,2020_06,855,712,143,83.3,0.028
420,CCB,2020_07,993,824,169,83.0,0.041
421,CCB,2020_08,483,389,94,80.5,0.037
422,CCB,2020_09,622,510,112,82.0,0.08
423,CCB,2020_10,615,514,101,83.6,0.093
424,CCB,2020_11,1038,852,186,82.1,0.089
425,CCB,2020_12,905,709,196,78.3,-0.023
426,CCB,2021_01,805,653,152,81.1,0.107
427,CCB,2021_02,675,553,122,81.9,0.055
428,CCB,2021_03,961,801,160,83.4,-0.009
429,CCB,2021_04,435,351,84,80.7,-0.009
430,CCB,2021_05,521,429,92,82.3,0.032
431,CCB,2021_06,372,312,60,83.9,0.062
432,CCB,2021_07,364,302,62,83.0,0.042
433,CCB,2021_08,349,303,46,86.8,0.068
434,CCB,2021_09,397,318,79,80.1,-0.045
435,CCB,2021_10,565,456,109,80.7,-0.0
436,CCB,2021_11,583,480,103,82.3,0.029
437,CCB,2021_12,1108,912,196,82.3,-0.048
438,CCB,2022_01,620,523,97,84.4,0.118
439,CCB,2022_02,635,523,112,82.4,0.008
440,CCB,2022_03,1253,1024,229,81.7,0.006
441,CCB,2022_04,667,535,132,80.2,-0.002
442,CCB,2022_05,1208,982,226,81.3,0.057
443,CCB,2022_06,1468,1150,318,78.3,-0.062
444,CCB,2022_07,881,729,152,82.7,0.089
445,CCB,2022_08,731,609,122,83.3,-0.003
446,CCB,2022_09,851,571,280,67.1,-0.051
447,CCB,2022_10,1773,1465,308,82.6,0.131
448,CCB,2022_11,1429,1139,290,79.7,0.078
449,CCB,2022_12,90,74,16,82.2,-0.035
450,CCS,2018_11,444,376,68,84.7,0.153
451,CCS,2018_12,757,625,132,82.6,-0.05
452,CCS,2019_01,411,344,67,83.7,-0.024
453,CCS,2019_02,134,108,26,80.6,-0.014
454,CCS,2019_03,172,148,24,86.0,-0.027
455,CCS,2019_04,134,112,22,83.6,0.167
456,CCS,2019_05,536,440,96,82.1,0.036
457,CCS,2019_06,102,87,15,85.3,0.113
458,CCS,2019_07,175,144,31,82.3,0.074
459,CCS,2019_08,511,422,89,82.6,0.079
460,CCS,2019_09,243,203,40,83.5,-0.07
461,CCS,2019_10,197,161,36,81.7,-0.046
462,CCS,2019_11,124,100,24,80.6,-0.015
463,CCS,2019_12,141,108,33,76.6,-0.023
464,CCS,2020_01,527,433,94,82.2,0.014
465,CCS,2020_02,695,584,111,84.0,0.035
466,CCS,2020_03,1822,1488,334,81.7,0.137
467,CCS,2020_04,1023,836,187,81.7,0.11
468,CCS,2020_05,627,515,112,82.1,0.044
469,CCS,2020_06,984,832,152,84.6,0.036
470,CCS,2020_07,781,650,131,83.2,0.052
471,CCS,2020_08,400,322,78,80.5,0.086
472,CCS,2020_09,993,831,162,83.7,0.038
473,CCS,2020_10,877,697,180,79.5,0.084
474,CCS,2020_11,351,294,57,83.8,-0.124
475,CCS,2020_12,811,655,156,80.8,0.005
476,CCS,2021_01,846,727,119,85.9,0.021
477,CCS,2021_02,782,675,107,86.3,0.068
478,CCS,2021_03,948,769,179,81.1,-0.046
479,CCS,2021_04,316,255,61,80.7,0.015
480,CCS,2021_05,793,669,124,84.4,-0.014
481,CCS,2021_06,295,246,49,83.4,0.152
482,CCS,2021_07,563,463,100,82.2,0.062
483,CCS,2021_08,434,363,71,83.6,0.045
484,CCS,2021_09,505,400,105,79.2,0.086
485,CCS,2021_10,362,307,55,84.8,0.076
486,CCS,2021_11,863,673,190,78.0,-0.107
487,CCS,2021_12,573,475,98,82.9,0.025
488,CCS,2022_01,740,571,169,77.2,-0.067
489,CCS,2022_02,782,645,137,82.5,0.061
490,CCS,2022_03,1025,866,159,84.5,0.018
491,CCS,2022_04,708,580,128,81.9,-0.007
492,CCS,2022_05,946,807,139,85.3,0.066
493,CCS,2022_06,1576,1327,249,84.2,0.04
494,CCS,2022_07,1046,859,187,82.1,-0.077
495,CCS,2022_08,812,694,118,85.5,0.046
496,CCS,2022_09,919,819,100,89.1,0.05
497,CCS,2022_10,1029,858,171,83.4,-0.042
498,CCS,2022_11,1289,951,338,73.8,-0.042
499,CCS,2022_12,127,115,12,90.6,0.057
500,DB,2018_11,1360,841,519,61.8,0.089
501,DB,2018_12,2135,1253,882,58.7,0.137
502,DB,2019_01,1066,715,351,67.1,0.179
503,DB,2019_02,469,306,163,65.2,0.125
504,DB,2019_03,685,443,242,64.7,0.128
505,DB,2019_04,508,330,178,65.0,0.044
506,DB,2019_05,2672,1577,1095,59.0,0.059
507,DB,2019_06,567,408,159,72.0,0.072
508,DB,2019_07,634,434,200,68.5,0.16
509,DB,2019_08,1927,1194,733,62.0,0.063
510,DB,2019_09,919,604,315,65.7,0.177
511,DB,2019_10,755,492,263,65.2,0.027
512,DB,2019_11,536,348,188,64.9,0.133
513,DB,2019_12,663,433,230,65.3,0.136
514,DB,2020_01,1458,916,542,62.8,0.192
515,DB,2020_02,2070,1181,889,57.1,0.09
516,DB,2020_03,5373,3106,2267,57.8,0.34
517,DB,2020_04,4563,2941,1622,64.5,0.16
518,DB,2020_05,2356,1567,789,66.5,0.222
519,DB,2020_06,3615,2125,1490,58.8,0.259
520,DB,2020_07,2813,1852,961,65.8,0.244
521,DB,2020_08,1494,912,582,61.0,0.111
522,DB,2020_09,2281,1412,869,61.9,0.082
523,DB,2020_10,2358,1551,807,65.8,0.143
524,DB,2020_11,1735,1098,637,63.3,0.167
525,DB,2020_12,2389,1570,819,65.7,0.064
526,DB,2021_01,3104,2039,1065,65.7,1.096
527,DB,2021_02,2925,1829,1096,62.5,0.103
528,DB,2021_03,3044,1790,1254,58.8,2.143
529,DB,2021_04,1953,1247,706,63.9,0.088
530,DB,2021_05,2035,1321,714,64.9,0.221
531,DB,2021_06,1548,904,644,58.4,0.005
532,DB,2021_07,1640,968,672,59.0,3.81
533,DB,2021_08,1606,941,665,58.6,0.035
534,DB,2021_09,1878,1098,780,58.5,-0.034
535,DB,2021_10,1334,881,453,66.0,0.102
536,DB,2021_11,2051,1246,805,60.8,0.25
537,DB,2021_12,2620,1620,1000,61.8,0.131
538,DB,2022_01,2918,1792,1126,61.4,0.123
539,DB,2022_02,3439,2012,1427,58.5,-0.044
540,DB,2022_03,3628,2246,1382,61.9,-0.016
541,DB,2022_04,2532,1584,948,62.6,0.113
542,DB,2022_05,3780,2444,1336,64.7,-0.022
543,DB,2022_06,5101,3321,1780,65.1,-0.132
544,DB,2022_07,3090,2249,841,72.8,0.166
545,DB,2022_08,2913,1823,1090,62.6,0.084
546,DB,2022_09,3446,2162,1284,62.7,0.034
547,DB,2022_10,3267,2008,1259,61.5,0.255
548,DB,2022_11,3531,2043,1488,57.9,0.141
549,DB,2022_12,422,244,178,57.8,-0.021
550,DBB,2018_11,294,255,39,86.7,0.03
551,DBB,2018_12,422,371,51,87.9,0.287
552,DBB,2019_01,256,220,36,85.9,0.036
553,DBB,2019_02,101,90,11,89.1,0.09
554,DBB,2019_03,163,147,16,90.2,0.029
555,DBB,2019_04,127,108,19,85.0,0.085
556,DBB,2019_05,564,482,82,85.5,0.008
557,DBB,2019_06,133,115,18,86.5,0.122
558,DBB,2019_07,167,156,11,93.4,0.664
559,DBB,2019_08,389,338,51,86.9,0.046
560,DBB,2019_09,207,186,21,89.9,0.085
561,DBB,2019_10,185,162,23,87.6,0.036
562,DBB,2019_11,110,94,16,85.5,0.053
563,DBB,2019_12,179,156,23,87.2,0.053
564,DBB,2020_01,329,282,47,85.7,-0.014
565,DBB,2020_02,460,401,59,87.2,0.083
566,DBB,2020_03,1099,941,158,85.6,0.155
567,DBB,2020_04,1148,985,163,85.8,0.123
568,DBB,2020_05,552,484,68,87.7,0.122
569,DBB,2020_06,793,687,106,86.6,0.121
570,DBB,2020_07,649,586,63,90.3,0.075
571,DBB,2020_08,333,293,40,88.0,0.046
572,DBB,2020_09,559,496,63,88.7,0.024
573,DBB,2020_10,580,503,77,86.7,0.044
574,DBB,2020_11,416,358,58,86.1,0.182
575,DBB,2020_12,550,489,61,88.9,0.081
576,DBB,2021_01,753,670,83,89.0,2.939
577,DBB,2021_02,676,594,82,87.9,0.027
578,DBB,2021_03,644,579,65,89.9,0.119
579,DBB,2021_04,440,392,48,89.1,0.021
580,DBB,2021_05,513,443,70,86.4,0.131
581,DBB,2021_06,343,300,43,87.5,0.013
582,DBB,2021_07,383,334,49,87.2,0.087
583,DBB,2021_08,356,314,42,88.2,0.025
584,DBB,2021_09,408,356,52,87.3,-0.038
585,DBB,2021_10,310,283,27,91.3,0.092
586,DBB,2021_11,459,399,60,86.9,0.11
587,DBB,2021_12,610,534,76,87.5,-0.003
588,DBB,2022_01,638,584,54,91.5,0.132
589,DBB,2022_02,783,649,134,82.9,-0.017
590,DBB,2022_03,900,794,106,88.2,-0.022
591,DBB,2022_04,610,540,70,88.5,0.138
592,DBB,2022_05,955,812,143,85.0,-0.047
593,DBB,2022_06,1271,1097,174,86.3,-0.058
594,DBB,2022_07,988,914,74,92.5,0.092
595,DBB,2022_08,665,584,81,87.8,0.015
596,DBB,2022_09,806,712,94,88.3,0.041
597,DBB,2022_10,770,691,79,89.7,0.031
598,DBB,2022_11,830,697,133,84.0,0.073
599,DBB,2022_12,102,87,15,85.3,0.111
600,DT,2018_11,683,320,363,46.9,0.046
601,DT,2018_12,1254,603,651,48.1,0.203
602,DT,2019_01,1179,571,608,48.4,-0.038
603,DT,2019_02,287,150,137,52.3,-0.011
604,DT,2019_03,293,128,165,43.7,0.057
605,DT,2019_04,338,152,186,45.0,0.078
606,DT,2019_05,646,364,282,56.3,0.374
607,DT,2019_06,398,185,213,46.5,-0.043
608,DT,2019_07,316,171,145,54.1,0.083
609,DT,2019_08,851,400,451,47.0,0.084
610,DT,2019_09,567,297,270,52.4,-0.192
611,DT,2019_10,496,246,250,49.6,0.005
612,DT,2019_11,299,142,157,47.5,-0.025
613,DT,2019_12,320,155,165,48.4,-0.016
614,DT,2020_01,560,323,237,57.7,0.056
615,DT,2020_02,718,371,347,51.7,0.027
616,DT,2020_03,2445,1235,1210,50.5,0.192
617,DT,2020_04,2804,1365,1439,48.7,0.046
618,DT,2020_05,1495,735,760,49.2,-0.111
619,DT,2020_06,1678,888,790,52.9,0.336
620,DT,2020_07,1501,798,703,53.2,0.12
621,DT,2020_08,766,361,405,47.1,0.149
622,DT,2020_09,1266,631,635,49.8,0.182
623,DT,2020_10,1270,647,623,50.9,0.03
624,DT,2020_11,1523,732,791,48.1,0.013
625,DT,2020_12,1347,717,630,53.2,0.09
626,DT,2021_01,1681,811,870,48.2,-0.012
627,DT,2021_02,1548,724,824,46.8,-0.107
628,DT,2021_03,2353,1100,1253,46.7,0.015
629,DT,2021_04,922,481,441,52.2,0.009
630,DT,2021_05,1189,646,543,54.3,0.245
631,DT,2021_06,583,304,279,52.1,-0.207
632,DT,2021_07,767,420,347,54.8,0.093
633,DT,2021_08,708,364,344,51.4,0.086
634,DT,2021_09,660,355,305,53.8,0.028
635,DT,2021_10,747,340,407,45.5,0.145
636,DT,2021_11,1009,514,495,50.9,0.268
637,DT,2021_12,1329,665,664,50.0,0.131
638,DT,2022_01,1168,603,565,51.6,-0.008
639,DT,2022_02,1530,754,776,49.3,0.298
640,DT,2022_03,2102,1076,1026,51.2,0.269
641,DT,2022_04,851,476,375,55.9,0.141
642,DT,2022_05,1830,1016,814,55.5,0.125
643,DT,2022_06,1845,1081,764,58.6,0.323
644,DT,2022_07,1948,878,1070,45.1,0.169
645,DT,2022_08,1274,671,603,52.7,0.028
646,DT,2022_09,1090,562,528,51.6,0.14
647,DT,2022_10,1966,990,976,50.4,0.075
648,DT,2022_11,1826,901,925,49.3,0.08
649,DT,2022_12,145,78,67,53.8,0.386
650,DTS,2018_11,135,122,13,90.4,0.054
651,DTS,2018_12,281,261,20,92.9,0.126
652,DTS,2019_01,193,174,19,90.2,-0.023
653,DTS,2019_02,54,49,5,90.7,-0.153
654,DTS,2019_03,60,54,6,90.0,0.185
655,DTS,2019_04,63,55,8,87.3,0.107
656,DTS,2019_05,153,137,16,89.5,0.341
657,DTS,2019_06,78,71,7,91.0,0.093
658,DTS,2019_07,67,59,8,88.1,0.096
659,DTS,2019_08,175,151,24,86.3,-0.031
660,DTS,2019_09,140,128,12,91.4,-0.095
661,DTS,2019_10,121,111,10,91.7,0.149
662,DTS,2019_11,68,61,7,89.7,-0.128
663,DTS,2019_12,74,65,9,87.8,-0.11
664,DTS,2020_01,117,109,8,93.2,0.035
665,DTS,2020_02,152,141,11,92.8,0.149
666,DTS,2020_03,513,461,52,89.9,0.186
667,DTS,2020_04,634,559,75,88.2,-0.007
668,DTS,2020_05,343,310,33,90.4,-0.066
669,DTS,2020_06,455,428,27,94.1,0.044
670,DTS,2020_07,322,291,31,90.4,0.031
671,DTS,2020_08,173,151,22,87.3,0.011
672,DTS,2020_09,277,257,20,92.8,0.049
673,DTS,2020_10,275,243,32,88.4,-0.1
674,DTS,2020_11,346,316,30,91.3,-0.022
675,DTS,2020_12,331,301,30,90.9,-0.008
676,DTS,2021_01,397,358,39,90.2,0.029
677,DTS,2021_02,309,262,47,84.8,-0.133
678,DTS,2021_03,484,429,55,88.6,0.052
679,DTS,2021_04,180,162,18,90.0,-0.243
680,DTS,2021_05,238,215,23,90.3,0.065
681,DTS,2021_06,136,127,9,93.4,0.03
682,DTS,2021_07,185,174,11,94.1,0.036
683,DTS,2021_08,163,145,18,89.0,0.259
684,DTS,2021_09,169,150,19,88.8,-0.018
685,DTS,2021_10,160,149,11,93.1,0.039
686,DTS,2021_11,223,197,26,88.3,0.149
687,DTS,2021_12,345,317,28,91.9,0.011
688,DTS,2022_01,259,226,33,87.3,0.04
689,DTS,2022_02,314,286,28,91.1,0.109
690,DTS,2022_03,461,427,34,92.6,0.155
691,DTS,2022_04,222,215,7,96.8,0.116
692,DTS,2022_05,429,388,41,90.4,0.073
693,DTS,2022_06,544,507,37,93.2,0.089
694,DTS,2022_07,326,303,23,92.9,0.062
695,DTS,2022_08,293,259,34,88.4,0.04
696,DTS,2022_09,265,247,18,93.2,0.04
697,DTS,2022_10,409,362,47,88.5,0.019
698,DTS,2022_11,415,378,37,91.1,0.035
699,DTS,2022_12,38,34,4,89.5,0.242
700,PBB,2018_11,21,17,4,81.0,0.215
701,PBB,2018_12,9,9,0,100.0,-0.343
702,PBB,2019_01,14,9,5,64.3,-0.256
703,PBB,2019_02,2,2,0,100.0,0.14
704,PBB,2019_03,2,2,0,100.0,0.16
705,PBB,2019_04,7,6,1,85.7,-0.102
706,PBB,2019_05,21,14,7,66.7,-0.664
707,PBB,2019_06,2,2,0,100.0,-0.23
708,PBB,2019_07,9,7,2,77.8,1.437
709,PBB,2019_08,16,13,3,81.2,0.345
710,PBB,2019_09,8,8,0,100.0,-0.631
711,PBB,2019_10,16,10,6,62.5,-0.284
712,PBB,2019_11,5,4,1,80.0,0.792
713,PBB,2019_12,3,3,0,100.0,0.133
714,PBB,2020_01,8,6,2,75.0,0.483
715,PBB,2020_02,16,14,2,87.5,-0.237
716,PBB,2020_03,7,5,2,71.4,1.984
717,PBB,2020_04,6,6,0,100.0,1.788
718,PBB,2020_05,7,6,1,85.7,0.663
719,PBB,2020_06,9,4,5,44.4,1.818
720,PBB,2020_07,16,11,5,68.8,-0.346
721,PBB,2020_08,18,15,3,83.3,-0.539
722,PBB,2020_09,29,18,11,62.1,-0.312
723,PBB,2020_10,26,17,9,65.4,0.475
724,PBB,2020_11,20,18,2,90.0,0.973
725,PBB,2020_12,7,7,0,100.0,0.689
726,PBB,2021_01,27,24,3,88.9,0.887
727,PBB,2021_02,159,154,5,96.9,1.32
728,PBB,2021_03,16,10,6,62.5,-0.638
729,PBB,2021_04,15,8,7,53.3,0.321
730,PBB,2021_05,27,19,8,70.4,-0.591
731,PBB,2021_06,9,6,3,66.7,-0.462
732,PBB,2021_07,28,20,8,71.4,0.459
733,PBB,2021_08,25,20,5,80.0,0.297
734,PBB,2021_09,37,24,13,64.9,-0.124
735,PBB,2021_10,23,19,4,82.6,0.279
736,PBB,2021_11,65,42,23,64.6,-0.07
737,PBB,2021_12,19,10,9,52.6,0.071
738,PBB,2022_01,18,11,7,61.1,-0.739
739,PBB,2022_02,23,20,3,87.0,0.608
740,PBB,2022_03,38,31,7,81.6,-0.104
741,PBB,2022_04,40,30,10,75.0,0.751
742,PBB,2022_05,30,22,8,73.3,0.12
743,PBB,2022_06,41,33,8,80.5,-0.445
744,PBB,2022_07,43,30,13,69.8,-0.149
745,PBB,2022_08,23,17,6,73.9,-0.428
746,PBB,2022_09,40,32,8,80.0,-0.522
747,PBB,2022_10,39,32,7,82.1,0.096
748,PBB,2022_11,39,30,9,76.9,-0.14
749,PBB,2022_12,4,3,1,75.0,-0.28
750,PBS,2018_11,16,11,5,68.8,0.988
751,PBS,2018_12,4,4,0,100.0,1.147
752,PBS,2019_01,14,11,3,78.6,-0.811
753,PBS,2019_02,7,6,1,85.7,0.186
754,PBS,2019_03,2,2,0,100.0,-1.355
755,PBS,2019_04,1,1,0,100.0,1.03
756,PBS,2019_05,13,10,3,76.9,0.191
757,PBS,2019_06,5,2,3,40.0,-1.405
758,PBS,2019_07,11,8,3,72.7,0.454
759,PBS,2019_08,11,11,0,100.0,0.276
760,PBS,2019_09,11,8,3,72.7,-1.204
761,PBS,2019_10,9,8,1,88.9,-0.341
762,PBS,2019_11,16,9,7,56.2,0.496
763,PBS,2019_12,4,3,1,75.0,-0.317
764,PBS,2020_01,3,1,2,33.3,-1.64
765,PBS,2020_02,13,10,3,76.9,0.009
766,PBS,2020_03,11,8,3,72.7,3.49
767,PBS,2020_04,34,26,8,76.5,0.479
768,PBS,2020_05,37,30,7,81.1,-0.192
769,PBS,2020_06,23,17,6,73.9,0.293
770,PBS,2020_07,55,39,16,70.9,0.273
771,PBS,2020_08,27,19,8,70.4,0.273
772,PBS,2020_09,32,20,12,62.5,0.213
773,PBS,2020_10,26,19,7,73.1,0.278
774,PBS,2020_11,54,40,14,74.1,0.584
775,PBS,2020_12,37,27,10,73.0,-0.385
776,PBS,2021_01,82,63,19,76.8,0.122
777,PBS,2021_02,49,36,13,73.5,0.806
778,PBS,2021_03,18,16,2,88.9,-0.094
779,PBS,2021_04,25,14,11,56.0,0.643
780,PBS,2021_05,25,18,7,72.0,-0.105
781,PBS,2021_06,19,15,4,78.9,-0.228
782,PBS,2021_07,22,16,6,72.7,0.576
783,PBS,2021_08,35,31,4,88.6,-0.297
784,PBS,2021_09,39,26,13,66.7,-0.022
785,PBS,2021_10,29,17,12,58.6,-0.324
786,PBS,2021_11,38,28,10,73.7,-0.144
787,PBS,2021_12,12,11,1,91.7,-1.527
788,PBS,2022_01,9,8,1,88.9,0.422
789,PBS,2022_02,25,15,10,60.0,-0.429
790,PBS,2022_03,41,34,7,82.9,-0.696
791,PBS,2022_04,32,26,6,81.2,-0.404
792,PBS,2022_05,24,18,6,75.0,0.652
793,PBS,2022_06,26,17,9,65.4,-0.097
794,PBS,2022_07,38,31,7,81.6,0.961
795,PBS,2022_08,38,21,17,55.3,0.739
796,PBS,2022_09,20,15,5,75.0,0.011
797,PBS,2022_10,28,23,5,82.1,-0.119
798,PBS,2022_11,68,32,36,47.1,-0.395
799,PBS,2022_12,2,1,1,50.0,-1.82
800,SBRT,2018_11,280,192,88,68.6,-0.094
801,SBRT,2018_12,448,297,151,66.3,0.001
802,SBRT,2019_01,206,137,69,66.5,0.041
803,SBRT,2019_02,92,70,22,76.1,0.134
804,SBRT,2019_03,142,93,49,65.5,0.038
805,SBRT,2019_04,84,60,24,71.4,0.102
806,SBRT,2019_05,646,460,186,71.2,0.01
807,SBRT,2019_06,99,70,29,70.7,0.042
808,SBRT,2019_07,103,76,27,73.8,0.064
809,SBRT,2019_08,475,319,156,67.2,0.032
810,SBRT,2019_09,163,105,58,64.4,0.075
811,SBRT,2019_10,157,110,47,70.1,0.059
812,SBRT,2019_11,95,62,33,65.3,-0.067
813,SBRT,2019_12,122,88,34,72.1,0.002
814,SBRT,2020_01,293,211,82,72.0,0.003
815,SBRT,2020_02,532,309,223,58.1,0.065
816,SBRT,2020_03,1135,727,408,64.1,0.041
817,SBRT,2020_04,963,653,310,67.8,-0.049
818,SBRT,2020_05,480,334,146,69.6,0.039
819,SBRT,2020_06,791,555,236,70.2,0.067
820,SBRT,2020_07,496,346,150,69.8,0.104
821,SBRT,2020_08,274,199,75,72.6,0.085
822,SBRT,2020_09,586,366,220,62.5,0.051
823,SBRT,2020_10,546,363,183,66.5,0.043
824,SBRT,2020_11,258,169,89,65.5,0.071
825,SBRT,2020_12,441,312,129,70.7,-0.038
826,SBRT,2021_01,649,442,207,68.1,0.127
827,SBRT,2021_02,581,391,190,67.3,-0.019
828,SBRT,2021_03,581,355,226,61.1,0.057
829,SBRT,2021_04,355,230,125,64.8,0.039
830,SBRT,2021_05,457,323,134,70.7,0.044
831,SBRT,2021_06,303,190,113,62.7,0.01
832,SBRT,2021_07,354,246,108,69.5,-0.036
833,SBRT,2021_08,324,229,95,70.7,0.001
834,SBRT,2021_09,560,318,242,56.8,0.026
835,SBRT,2021_10,273,171,102,62.6,0.039
836,SBRT,2021_11,419,278,141,66.3,0.077
837,SBRT,2021_12,603,395,208,65.5,0.05
838,SBRT,2022_01,687,438,249,63.8,0.005
839,SBRT,2022_02,853,550,303,64.5,-0.006
840,SBRT,2022_03,856,596,260,69.6,0.011
841,SBRT,2022_04,596,407,189,68.3,0.099
842,SBRT,2022_05,905,618,287,68.3,0.046
843,SBRT,2022_06,1401,962,439,68.7,0.001
844,SBRT,2022_07,666,480,186,72.1,0.141
845,SBRT,2022_08,639,457,182,71.5,0.032
846,SBRT,2022_09,826,541,285,65.5,0.031
847,SBRT,2022_10,725,480,245,66.2,0.078
848,SBRT,2022_11,838,557,281,66.5,-0.011
849,SBRT,2022_12,80,51,29,63.7,-0.047
850,SSD,2018_11,1322,998,324,75.5,-0.002
851,SSD,2018_12,1556,1294,262,83.2,-0.012
852,SSD,2019_01,1051,786,265,74.8,-0.115
853,SSD,2019_02,736,541,195,73.5,-0.076
854,SSD,2019_03,828,620,208,74.9,-0.129
855,SSD,2019_04,804,639,165,79.5,-0.018
856,SSD,2019_05,1662,1265,397,76.1,0.137
857,SSD,2019_06,868,680,188,78.3,0.07
858,SSD,2019_07,1001,765,236,76.4,0.049
859,SSD,2019_08,1907,1515,392,79.4,0.033
860,SSD,2019_09,1133,874,259,77.1,-0.076
861,SSD,2019_10,1104,829,275,75.1,0.032
862,SSD,2019_11,890,676,214,76.0,0.014
863,SSD,2019_12,939,693,246,73.8,-0.09
864,SSD,2020_01,1944,1452,492,74.7,-0.059
865,SSD,2020_02,1881,1489,392,79.2,0.15
866,SSD,2020_03,5061,4010,1051,79.2,0.332
867,SSD,2020_04,4525,3461,1064,76.5,0.206
868,SSD,2020_05,2552,1910,642,74.8,0.019
869,SSD,2020_06,3826,3012,814,78.7,0.064
870,SSD,2020_07,3493,2646,847,75.8,-0.121
871,SSD,2020_08,2045,1523,522,74.5,0.035
872,SSD,2020_09,2356,1825,531,77.5,-0.035
873,SSD,2020_10,2371,1759,612,74.2,-0.046
874,SSD,2020_11,2566,1955,611,76.2,-0.0
875,SSD,2020_12,2938,2240,698,76.2,-0.021
876,SSD,2021_01,3780,2840,940,75.1,0.001
877,SSD,2021_02,4215,3130,1085,74.3,0.039
878,SSD,2021_03,2973,2319,654,78.0,0.324
879,SSD,2021_04,2226,1724,502,77.4,-0.041
880,SSD,2021_05,2394,1815,579,75.8,0.047
881,SSD,2021_06,1917,1497,420,78.1,0.004
882,SSD,2021_07,2040,1576,464,77.3,0.115
883,SSD,2021_08,2066,1587,479,76.8,0.104
884,SSD,2021_09,2042,1612,430,78.9,0.029
885,SSD,2021_10,1782,1357,425,76.2,0.026
886,SSD,2021_11,2602,2045,557,78.6,0.14
887,SSD,2021_12,2412,1808,604,75.0,0.031
888,SSD,2022_01,2193,1685,508,76.8,0.291
889,SSD,2022_02,2512,1953,559,77.7,0.42
890,SSD,2022_03,2895,2269,626,78.4,0.316
891,SSD,2022_04,1940,1534,406,79.1,0.148
892,SSD,2022_05,2315,1849,466,79.9,0.098
893,SSD,2022_06,3910,3087,823,79.0,0.029
894,SSD,2022_07,2909,2096,813,72.1,-0.073
895,SSD,2022_08,3098,2402,696,77.5,-0.021
896,SSD,2022_09,2524,2015,509,79.8,0.021
897,SSD,2022_10,2812,2244,568,79.8,-0.027
898,SSD,2022_11,3799,2838,961,74.7,-0.229
899,SSD,2022_12,530,389,141,73.4,0.085
900,SSRT,2018_11,118,81,37,68.6,0.021
901,SSRT,2018_12,258,138,120,53.5,0.08
902,SSRT,2019_01,245,162,83,66.1,-0.07
903,SSRT,2019_02,45,32,13,71.1,0.201
904,SSRT,2019_03,58,44,14,75.9,-0.106
905,SSRT,2019_04,58,35,23,60.3,-0.049
906,SSRT,2019_05,121,96,25,79.3,0.256
907,SSRT,2019_06,71,48,23,67.6,-0.048
908,SSRT,2019_07,45,26,19,57.8,0.118
909,SSRT,2019_08,135,90,45,66.7,0.104
910,SSRT,2019_09,82,59,23,72.0,-0.073
911,SSRT,2019_10,96,67,29,69.8,-0.136
912,SSRT,2019_11,57,38,19,66.7,0.095
913,SSRT,2019_12,50,37,13,74.0,0.066
914,SSRT,2020_01,100,60,40,60.0,0.119
915,SSRT,2020_02,109,70,39,64.2,-0.031
916,SSRT,2020_03,385,254,131,66.0,0.281
917,SSRT,2020_04,534,362,172,67.8,0.004
918,SSRT,2020_05,272,187,85,68.8,-0.04
919,SSRT,2020_06,269,185,84,68.8,0.104
920,SSRT,2020_07,216,137,79,63.4,0.072
921,SSRT,2020_08,155,93,62,60.0,0.036
922,SSRT,2020_09,236,148,88,62.7,0.046
923,SSRT,2020_10,208,143,65,68.8,-0.027
924,SSRT,2020_11,307,193,114,62.9,0.004
925,SSRT,2020_12,218,141,77,64.7,-0.007
926,SSRT,2021_01,294,198,96,67.3,-0.179
927,SSRT,2021_02,299,199,100,66.6,-0.017
928,SSRT,2021_03,439,306,133,69.7,0.023
929,SSRT,2021_04,162,116,46,71.6,-0.059
930,SSRT,2021_05,195,133,62,68.2,0.089
931,SSRT,2021_06,112,61,51,54.5,0.106
932,SSRT,2021_07,125,88,37,70.4,0.046
933,SSRT,2021_08,135,96,39,71.1,-0.005
934,SSRT,2021_09,105,77,28,73.3,0.186
935,SSRT,2021_10,163,112,51,68.7,0.079
936,SSRT,2021_11,189,116,73,61.4,-0.045
937,SSRT,2021_12,222,153,69,68.9,0.082
938,SSRT,2022_01,198,135,63,68.2,-0.075
939,SSRT,2022_02,281,181,100,64.4,0.064
940,SSRT,2022_03,384,268,116,69.8,0.021
941,SSRT,2022_04,162,117,45,72.2,0.017
942,SSRT,2022_05,326,224,102,68.7,0.128
943,SSRT,2022_06,321,229,92,71.3,0.078
944,SSRT,2022_07,386,260,126,67.4,0.016
945,SSRT,2022_08,247,175,72,70.9,0.021
946,SSRT,2022_09,173,116,57,67.1,0.071
947,SSRT,2022_10,370,248,122,67.0,0.037
948,SSRT,2022_11,328,227,101,69.2,0.086
949,SSRT,2022_12,25,16,9,64.0,0.303
950,SSU,2018_11,1238,945,293,76.3,0.145
951,SSU,2018_12,981,769,212,78.4,-0.021
952,SSU,2019_01,1673,1311,362,78.4,0.086
953,SSU,2019_02,832,640,192,76.9,0.02
954,SSU,2019_03,771,617,154,80.0,0.255
955,SSU,2019_04,916,718,198,78.4,0.082
956,SSU,2019_05,1549,1215,334,78.4,-0.027
957,SSU,2019_06,914,729,185,79.8,0.161
958,SSU,2019_07,928,701,227,75.5,0.011
959,SSU,2019_08,1955,1539,416,78.7,0.018
960,SSU,2019_09,1178,944,234,80.1,0.165
961,SSU,2019_10,1147,890,257,77.6,0.067
962,SSU,2019_11,891,709,182,79.6,0.046
963,SSU,2019_12,1066,808,258,75.8,0.124
964,SSU,2020_01,1711,1302,409,76.1,-0.042
965,SSU,2020_02,1652,1269,383,76.8,0.112
966,SSU,2020_03,3628,2857,771,78.7,0.233
967,SSU,2020_04,4412,3316,1096,75.2,0.156
968,SSU,2020_05,2747,2147,600,78.2,0.13
969,SSU,2020_06,3206,2468,738,77.0,-0.006
970,SSU,2020_07,3481,2709,772,77.8,0.142
971,SSU,2020_08,1935,1525,410,78.8,0.051
972,SSU,2020_09,2695,2135,560,79.2,0.043
973,SSU,2020_10,2531,1995,536,78.8,0.189
974,SSU,2020_11,3209,2400,809,74.8,0.124
975,SSU,2020_12,3267,2568,699,78.6,0.043
976,SSU,2021_01,3929,3001,928,76.4,0.592
977,SSU,2021_02,4444,3471,973,78.1,0.755
978,SSU,2021_03,3583,2740,843,76.5,3.585
979,SSU,2021_04,1878,1497,381,79.7,0.057
980,SSU,2021_05,2726,2059,667,75.5,0.017
981,SSU,2021_06,1502,1181,321,78.6,1.512
982,SSU,2021_07,2220,1657,563,74.6,-0.127
983,SSU,2021_08,2037,1563,474,76.7,0.026
984,SSU,2021_09,1477,1130,347,76.5,-0.058
985,SSU,2021_10,1766,1406,360,79.6,0.075
986,SSU,2021_11,2370,1749,621,73.8,-0.133
987,SSU,2021_12,2609,2080,529,79.7,-0.006
988,SSU,2022_01,1801,1359,442,75.5,0.092
989,SSU,2022_02,2408,1879,529,78.0,0.084
990,SSU,2022_03,3137,2441,696,77.8,0.028
991,SSU,2022_04,1496,1104,392,73.8,0.046
992,SSU,2022_05,2326,1758,568,75.6,-0.114
993,SSU,2022_06,3299,2643,656,80.1,-0.123
994,SSU,2022_07,4486,3662,824,81.6,0.052
995,SSU,2022_08,2929,2297,632,78.4,0.057
996,SSU,2022_09,1613,1225,388,75.9,0.01
997,SSU,2022_10,3159,2527,632,80.0,0.242
998,SSU,2022_11,3487,2708,779,77.7,0.257
999,SSU,2022_12,446,328,118,73.5,0.096
1000,TAG,2018_11,175,158,17,90.3,0.133
1001,TAG,2018_12,289,251,38,86.9,0.039
1002,TAG,2019_01,201,179,22,89.1,0.248
1003,TAG,2019_02,80,71,9,88.8,0.03
1004,TAG,2019_03,107,97,10,90.7,0.034
1005,TAG,2019_04,94,81,13,86.2,0.13
1006,TAG,2019_05,242,208,34,86.0,0.073
1007,TAG,2019_06,83,73,10,88.0,-0.037
1008,TAG,2019_07,96,83,13,86.5,-0.105
1009,TAG,2019_08,223,193,30,86.5,0.042
1010,TAG,2019_09,133,114,19,85.7,0.114
1011,TAG,2019_10,104,94,10,90.4,0.151
1012,TAG,2019_11,105,88,17,83.8,0.113
1013,TAG,2019_12,78,69,9,88.5,0.282
1014,TAG,2020_01,188,168,20,89.4,0.043
1015,TAG,2020_02,355,322,33,90.7,0.386
1016,TAG,2020_03,788,672,116,85.3,0.471
1017,TAG,2020_04,681,582,99,85.5,0.052
1018,TAG,2020_05,347,286,61,82.4,0.245
1019,TAG,2020_06,675,545,130,80.7,-0.123
1020,TAG,2020_07,391,337,54,86.2,0.089
1021,TAG,2020_08,243,216,27,88.9,0.24
1022,TAG,2020_09,417,367,50,88.0,0.07
1023,TAG,2020_10,418,358,60,85.6,0.118
1024,TAG,2020_11,375,339,36,90.4,0.162
1025,TAG,2020_12,448,395,53,88.2,0.131
1026,TAG,2021_01,582,499,83,85.7,0.317
1027,TAG,2021_02,465,411,54,88.4,0.116
1028,TAG,2021_03,535,473,62,88.4,0.092
1029,TAG,2021_04,246,218,28,88.6,-0.024
1030,TAG,2021_05,325,285,40,87.7,0.126
1031,TAG,2021_06,206,183,23,88.8,10.536
1032,TAG,2021_07,305,267,38,87.5,0.231
1033,TAG,2021_08,228,199,29,87.3,0.19
1034,TAG,2021_09,209,176,33,84.2,-0.135
1035,TAG,2021_10,200,173,27,86.5,0.096
1036,TAG,2021_11,417,342,75,82.0,-0.027
1037,TAG,2021_12,389,346,43,88.9,-0.067
1038,TAG,2022_01,501,405,96,80.8,-0.167
1039,TAG,2022_02,449,408,41,90.9,0.011
1040,TAG,2022_03,543,469,74,86.4,-0.058
1041,TAG,2022_04,301,238,63,79.1,-0.197
1042,TAG,2022_05,475,414,61,87.2,-0.146
1043,TAG,2022_06,588,525,63,89.3,-0.065
1044,TAG,2022_07,515,472,43,91.7,0.317
1045,TAG,2022_08,374,334,40,89.3,0.162
1046,TAG,2022_09,321,278,43,86.6,-0.135
1047,TAG,2022_10,552,488,64,88.4,0.109
1048,TAG,2022_11,596,491,105,82.4,0.347
1049,TAG,2022_12,43,35,8,81.4,0.071
1050,TAR,2018_11,188,172,16,91.5,-0.028
1051,TAR,2018_12,281,249,32,88.6,0.023
1052,TAR,2019_01,188,159,29,84.6,0.029
1053,TAR,2019_02,72,59,13,81.9,-0.074
1054,TAR,2019_03,91,78,13,85.7,-0.124
1055,TAR,2019_04,114,98,16,86.0,-0.091
1056,TAR,2019_05,249,208,41,83.5,0.099
1057,TAR,2019_06,109,92,17,84.4,0.044
1058,TAR,2019_07,105,94,11,89.5,0.045
1059,TAR,2019_08,310,277,33,89.4,0.1
1060,TAR,2019_09,109,92,17,84.4,-0.077
1061,TAR,2019_10,127,106,21,83.5,0.226
1062,TAR,2019_11,70,62,8,88.6,0.153
1063,TAR,2019_12,93,76,17,81.7,-0.044
1064,TAR,2020_01,212,184,28,86.8,0.077
1065,TAR,2020_02,369,338,31,91.6,0.099
1066,TAR,2020_03,781,666,115,85.3,0.169
1067,TAR,2020_04,657,554,103,84.3,0.295
1068,TAR,2020_05,325,275,50,84.6,0.089
1069,TAR,2020_06,593,509,84,85.8,0.114
1070,TAR,2020_07,389,346,43,88.9,0.143
1071,TAR,2020_08,279,239,40,85.7,-0.051
1072,TAR,2020_09,492,393,99,79.9,-0.209
1073,TAR,2020_10,379,321,58,84.7,0.002
1074,TAR,2020_11,380,325,55,85.5,0.085
1075,TAR,2020_12,349,303,46,86.8,0.051
1076,TAR,2021_01,484,400,84,82.6,-0.108
1077,TAR,2021_02,418,345,73,82.5,-0.095
1078,TAR,2021_03,500,439,61,87.8,-0.058
1079,TAR,2021_04,224,190,34,84.8,0.042
1080,TAR,2021_05,258,233,25,90.3,0.2
1081,TAR,2021_06,206,175,31,85.0,0.141
1082,TAR,2021_07,273,243,30,89.0,0.209
1083,TAR,2021_08,234,196,38,83.8,0.039
1084,TAR,2021_09,227,205,22,90.3,0.143
1085,TAR,2021_10,219,189,30,86.3,0.133
1086,TAR,2021_11,352,306,46,86.9,0.09
1087,TAR,2021_12,338,293,45,86.7,0.009
1088,TAR,2022_01,424,389,35,91.7,0.412
1089,TAR,2022_02,471,409,62,86.8,-0.033
1090,TAR,2022_03,614,550,64,89.6,-0.061
1091,TAR,2022_04,349,322,27,92.3,0.173
1092,TAR,2022_05,456,404,52,88.6,0.179
1093,TAR,2022_06,564,482,82,85.5,0.21
1094,TAR,2022_07,519,441,78,85.0,0.057
1095,TAR,2022_08,402,348,54,86.6,0.076
1096,TAR,2022_09,407,362,45,88.9,0.038
1097,TAR,2022_10,535,459,76,85.8,0.122
1098,TAR,2022_11,483,413,70,85.5,-0.066
1099,TAR,2022_12,55,49,6,89.1,-0.227
